           #
          #O#
         #   #
        #     #          ####   ####   ####
       #O     O#        #   #  #   #  #   #
      #   XXX   #       #      #      #
     #   X O X   #      #####  #####  #####    
    #O    XXX    O#     #   #  #   #  #   #
   #               #    #   #  #   #  #   #
  #        P        #    ###    ###    ###
 #O                 O#
#######################
